1111111111111111111
1000000000000000001
1000000000111000001
1001001000001000p01
1000000000001c00c01
10000 0000000000001
10000000000000000e1
1111111111111111111