1111111111111111111
1000000000000000001
1000000000001000001
1001001000000000001
1000000000p00000001
1111111111111111111