11111111111111111111
1e001000011100000001
100000000011100a0001
1001001000111000p001
10000100001110000001
10000000001110000c01
100000000000000000e1
11111111111111111111