1111111111111111111
1000p0c000000000001
1000000000111000001
1001001000001000001
10000000e0001000001
10000000000000000c1
10000000000c0000001
1111111111111111111