11111111111111111111
1E001000011100000001
100000000011100A0001
10010010001110000001
10000100001110000P01
10000000001110000C01
10000000000000000001
11111111111111111111