11111111111111111111
1E0010000111A000A001
10000000001110000001
1001001000111000P001
10000100001110000001
10000000001110000C01
10000000000000000001
11111111111111111111