11111111111111111111111
1e00p0c0000000000000001
10000000000011100000001
10010010000010000000001
100000000000000000000c1
11111111111111111111111