1111111111111111111
1e00p0c000000000001
1000000000111000001
1001001000001000001
1000000000001000001
1000000000000000001
10000000000c0000001
1111111111111111111