1111111111111111111
1e00p0c000000000001
1000000000001000001
1001001000000000001
1000000000000000001
1111111111111111111