11111111111111111111
1p0010c0001110000001
10000000001110000001
10010010c01110000001
100001c0e01110000001
100000c0001110000c01
100000c000ccc0000001
11111111111111111111