11111111111111111111
1E0010C0011100000001
100000000011100A0001
10010010C0111000P001
100001C0001110000001
100000C0001110000C01
100000C000CCC00000E1
11111111111111111111