11111111111111111111
100010c001110a000001
10000000001110000001
10010010c0111000p001
100001c0001110000001
100000c0001110000c01
100000c000ccc00000e1
11111111111111111111