11111111111111111111
1e0010c0011100000001
100000000011100a0001
10010010c0111000p001
100001c0001110000001
100000c0001110000c01
100000c000ccc00000e1
11111111111111111111