1111111111111111111
1p0010c000111000001
1000000000111000001
10010010c0111000001
100001c0e0111000001
100000c0001110000c1
100000c000ccc000001
1111111111111111111