11111111111111111111
1P1111C011111A00C001
101AC0001ACA00011A01
101C11100A0101011001
101000C00A0101011A01
101111C1000101011001
100000C10000C1CA11E1
11111111111111111111