11111111111111111111
1p1111c011111a00c001
101ac0001aca00011a01
101c11100a0101011a01
101000c00a0101011a01
101111c1000101011a01
100000c10000c1ca11e1
11111111111111111111