11111111111111111111
1p1111c011111100c001
1010000011c100011101
10101110010101011101
101000c1010101011101
101111c1010101011101
100000c10000c1c111e1
11111111111111111111