11111111111111111111
1p1111c011111a00c001
101ac0001aca00011a01
101c1110aa0101011a01
101000c00a0101011a01
101111c10a0101011a01
100000c10000c1ca11e1
11111111111111111111